6 10
WWWSWWWWWW
W....W.W.W
WWWW.....W
W.....WW.W
W.WWW..W.W
WE....WWWW
